NO ./north_texture.xpm
SO ./south_texture.xpm
WE ./west_texture.xpm
EA ./east_texture.xpm



F 102,255,204
C 153,255,255


        1111111111111111111111111
        10D0000000110000000000001
        1011000001110000000000001
        1001000000D00000000000001
111111111011000001110000000000001
10000000001100000111D111100011111
11110111111111011100000010001
1111D111111111011101010010001
11000000110101011100010010001
100000000000000011001000100011
100000000000000011010100100001
1100000111010101111101111N00111
11110111 1110101 101111010001
11111111 1111111 111111111111